,date,symbol,fillingDate,acceptedDate,period,netIncome,depreciationAndAmortization,deferredIncomeTax,stockBasedCompensation,changeInWorkingCapital,accountsReceivables,inventory,accountsPayables,otherWorkingCapital,otherNonCashItems,netCashProvidedByOperatingActivities,investmentsInPropertyPlantAndEquipment,acquisitionsNet,purchasesOfInvestments,salesMaturitiesOfInvestments,otherInvestingActivites,netCashUsedForInvestingActivites,debtRepayment,commonStockIssued,commonStockRepurchased,dividendsPaid,otherFinancingActivites,netCashUsedProvidedByFinancingActivities,effectOfForexChangesOnCash,netChangeInCash,cashAtEndOfPeriod,cashAtBeginningOfPeriod,operatingCashFlow,capitalExpenditure,freeCashFlow,link,finalLink
0,2019-09-30,CECO,,,Q3,18234000,2284000,7052000,1516000,28427000,0,0,0,220885000,0,31977000,0,0,-121490000,116279000,-1812000,-7023000,0,1146000,3693000,0,-3823000,1016000,0,25970000,47411000,21441000,31977000,0,31977000,,
0,2019-06-30,CECO,,,Q2,-559000,2235000,2435000,1037000,2898000,0,0,0,192458000,0,40469000,0,0,-157966000,130681000,-920000,-28205000,0,71000,-12305000,0,12275000,41000,0,12305000,51104000,38799000,40469000,0,40469000,,
0,2019-03-31,CECO,,,Q1,24791000,2233000,6778000,1369000,17164000,0,0,0,189560000,0,12945000,0,0,-138700000,135062000,-479000,-4117000,0,109000,-38799000,0,36267000,-2423000,0,6405000,38799000,32394000,12945000,0,12945000,,
0,2018-12-31,CECO,,,Q4,14071000,2345000,6689000,1471000,23906000,-10541000,0,698000,172396000,0,38692000,0,0,0,0,-38369000,-38369000,0,74000,-365000,0,333000,42000,0,365000,32394000,32029000,38692000,0,38692000,,
0,2018-09-30,CECO,,,Q3,14857000,2364000,4533000,1445000,23704000,0,0,0,148490000,0,3541000,0,0,0,0,-5482000,-5482000,0,438000,1146000,0,-1241000,343000,0,-1598000,32029000,33627000,3541000,0,3541000,,
0,2018-06-30,CECO,,,Q2,8751000,2103000,2937000,1197000,13488000,0,0,0,124786000,0,3658000,0,0,0,0,5261000,5261000,0,295000,-8977000,0,8740000,58000,0,8977000,33175000,24198000,3658000,0,3658000,,
0,2018-03-31,CECO,,,Q1,17502000,2582000,3704000,1501000,13264000,0,0,0,111298000,0,11096000,0,0,0,0,-2902000,-2902000,0,875000,-24198000,0,21217000,-2106000,0,6088000,24198000,18110000,11096000,0,11096000,,
0,2017-12-31,CECO,,,Q4,-44382000,2622000,53943000,1354000,8941000,5129000,0,-1588000,98034000,0,7318000,3426000,0,0,0,-8937000,-5511000,0,174000,-1834000,0,1817000,157000,-130000,1834000,18110000,16276000,7318000,-3426000,10744000,,
0,2017-09-30,CECO,,,Q3,3022000,3582000,1538000,1290000,379000,0,0,0,89093000,0,5139000,-1280000,0,0,0,-27102000,-28382000,0,89000,22622000,0,-22691000,20000,15000,-23208000,16276000,39484000,5139000,1280000,3859000,,
0,2017-06-30,CECO,,,Q2,4286000,3876000,4952000,1215000,6076000,0,0,0,88714000,0,4807000,-1411000,0,0,0,20068000,18657000,0,2321000,-25630000,0,25457000,2148000,18000,25630000,38898000,13268000,4807000,1411000,3396000,,
0,2017-03-31,CECO,,,Q1,5177000,3910000,3792000,1111000,3657000,0,0,0,82638000,0,-39053000,-735000,0,0,0,4324000,3589000,0,138000,-13268000,0,12340000,-790000,15000,-36239000,13268000,49507000,-39053000,735000,-39788000,,
0,2016-12-31,CECO,,,Q4,-32876000,5761000,-25460000,986000,-49999000,6925000,0,-16264000,78981000,0,-9802000,-777000,0,0,0,4277000,3500000,0,192000,6152000,0,-6152000,192000,-42000,-6152000,49507000,55659000,-9802000,777000,-10579000,,
0,2016-09-30,CECO,,,Q3,-686000,5215000,7373000,860000,8625000,0,0,0,128980000,0,9667000,-1382000,0,0,0,-2478000,-3860000,0,303000,-5996000,0,5996000,303000,-114000,5996000,55659000,49663000,9667000,1382000,8285000,,
0,2016-06-30,CECO,,,Q2,11839000,5202000,0,847000,21875000,0,0,0,120355000,0,16657000,-1094000,0,0,0,-24144000,-25238000,0,131000,-2127000,0,12487000,10491000,217000,2127000,49663000,47536000,16657000,1094000,15563000,,
0,2016-03-31,CECO,,,Q1,3011000,6569000,0,544000,2322000,0,0,0,98480000,0,-10610000,-876000,0,0,0,-7877000,-8753000,-38000000,147000,-47536000,0,85622000,233000,-253000,-19383000,47536000,66919000,-10610000,876000,-11486000,,
0,2015-12-31,CECO,,,Q4,142724000,5077000,-145807000,404000,4850000,-1517000,0,2539000,96158000,0,-683000,-3769000,0,0,0,177000,-3592000,0,319000,2021000,0,-154000,2186000,68000,-2021000,66919000,68940000,-683000,3769000,-4452000,,
0,2015-09-30,CECO,,,Q3,-45235000,5962000,0,983000,-47619000,0,0,0,91308000,0,5592000,-2932000,0,0,0,3201000,269000,0,143000,-5674000,0,5424000,-107000,-80000,5674000,68940000,63266000,5592000,2932000,2660000,,
0,2015-06-30,CECO,,,Q2,-20723000,7187000,0,530000,-15189000,0,0,0,138927000,0,-6419000,-1625000,0,0,0,831000,-794000,0,765000,5978000,0,-5478000,1265000,-30000,-5978000,63266000,69244000,-6419000,1625000,-8044000,,
0,2015-03-31,CECO,,,Q1,-24881000,6712000,0,940000,-25505000,0,0,0,154116000,0,-20176000,-3369000,0,0,0,-505000,-3874000,-10000000,174000,-69244000,0,78244000,-826000,288000,-24588000,69244000,93832000,-20176000,3369000,-23545000,,
0,2014-12-31,CECO,,,Q4,-25488000,12489000,14250000,966000,36976000,13281000,0,-830000,179621000,0,-17479000,-2598000,0,0,0,-14133000,-16731000,0,779000,33094000,0,-32794000,1079000,35000,-33096000,93832000,126928000,-17479000,2598000,-20077000,,
0,2014-09-30,CECO,,,Q3,-47968000,13141000,0,950000,-28053000,0,0,0,142645000,0,-19860000,-3527000,0,0,0,12791000,9264000,0,183000,11682000,0,-12992000,-1127000,43000,-11680000,126926000,138606000,-19860000,3527000,-23387000,,
0,2014-06-30,CECO,,,Q2,-46564000,14394000,0,1020000,-24509000,0,0,0,170698000,0,-45865000,-3563000,0,0,0,-77635000,-81198000,0,196000,125580000,0,-124560000,1216000,68000,-125779000,138608000,264387000,-45865000,3563000,-49428000,,
0,2014-03-31,CECO,,,Q1,-58143000,15431000,0,1341000,-57378000,0,0,0,195207000,0,-35420000,-3468000,0,0,0,-15490000,-18958000,0,196000,-264188000,0,263804000,-188000,10000,-54556000,264188000,318744000,-35420000,3468000,-38888000,,
0,2013-12-31,CECO,,,Q4,-30606000,16531000,58087000,1580000,51286000,56072000,0,-8463000,252585000,0,-7962000,-3034000,0,0,0,177353000,174319000,0,206000,-288019000,0,288020000,207000,-10362000,156202000,318943000,162741000,-7962000,3034000,-10996000,,
0,2013-09-30,CECO,,,Q3,-87064000,18384000,0,1713000,22146000,0,0,0,201299000,0,-10867000,-6597000,0,0,0,11750000,5153000,0,227000,134997000,0,-135595000,-371000,2899000,-3186000,30924000,34110000,-10867000,6597000,-17464000,,
0,2013-06-30,CECO,,,Q2,-31390000,18940000,0,1631000,-11094000,0,0,0,179153000,0,-52778000,-5928000,0,0,0,-578000,-6506000,0,261000,57895000,0,-58589000,-433000,1813000,-57904000,165921000,223825000,-52778000,5928000,-58706000,,
0,2013-03-31,CECO,,,Q1,-15203000,19295000,0,1775000,-599000,0,0,0,190247000,0,-14197000,-4077000,0,0,0,-2023000,-6100000,-80000000,304000,-223816000,0,310212000,6700000,-3194000,-16791000,223816000,240607000,-14197000,4077000,-18274000,,
0,2012-12-31,CECO,,,Q4,-61492000,21258000,-42014000,2385000,-43361000,17913000,0,-11984000,190846000,0,-49292000,-8448000,1373000,0,0,69868000,62793000,103000,337000,0,0,-18084000,-17644000,1937000,-2206000,240560000,242766000,-49292000,8448000,-57740000,,
0,2012-09-30,CECO,,,Q3,-33146000,20429000,0,1567000,-26870000,0,0,0,234207000,0,15917000,-9506000,-221000,0,0,34100000,24373000,100000,379000,0,0,-6018000,-5539000,-1235000,33516000,242828000,209312000,15917000,9506000,6411000,,
0,2012-06-30,CECO,,,Q2,-100234000,20020000,0,2955000,-26612000,0,0,0,261077000,0,-775000,-7687000,-2873000,0,0,-2519000,-13079000,-224000,406000,0,0,-188000,-6000,-6216000,-20076000,209312000,229388000,-775000,7687000,-8462000,,
0,2012-03-31,CECO,,,Q1,52076000,20106000,0,2780000,287689000,0,0,0,287689000,0,17352000,-12303000,0,-56431000,0,53002000,-15732000,547000,477000,-56431000,0,-1094000,-56501000,3677000,-51204000,229388000,280592000,17352000,12303000,5049000,,
0,2011-10-31,CECO,,,Q4,-139022000,-63319000,0,-11884000,-201374000,0,0,0,0,0,-209417000,67444000,0,137033000,0,-130443000,74034000,-855000,-3827000,137033000,0,1333000,133684000,2080000,381000,0,-381000,-209417000,-67444000,-141973000,,
0,2011-09-30,CECO,,,Q3,10634000,22446000,0,3396000,4011000,0,0,0,201374000,0,94665000,-19558000,0,-7154000,0,3036000,-23676000,111000,802000,-7154000,0,-167000,-6408000,-4301000,60280000,289101000,228821000,94665000,19558000,75107000,,
0,2011-06-30,CECO,,,Q2,55353000,20507000,0,4288000,17491000,0,0,0,197363000,0,55096000,-24094000,0,-39964000,0,35543000,-28515000,1385000,1733000,-39964000,0,-1325000,-38171000,1150000,-10440000,228821000,239261000,55096000,24094000,31002000,,
0,2011-03-31,CECO,,,Q1,73035000,20366000,0,4200000,24588000,0,0,0,179872000,0,59656000,-23792000,0,-89915000,0,91864000,-21843000,-641000,1292000,-89915000,0,159000,-89105000,1071000,-50221000,239261000,289482000,59656000,23792000,35864000,,
0,2010-12-31,CECO,,,Q4,12102000,19811000,17007000,2928000,38973000,0,0,4364000,155284000,0,54744000,-45339000,0,0,0,-4799000,-50138000,-2085000,656000,0,0,3164000,1735000,-374000,5967000,289482000,283515000,54744000,45339000,9405000,,
0,2010-09-30,CECO,,,Q3,26131000,17843000,0,4356000,8869000,0,0,0,116311000,0,169650000,-38788000,0,0,0,-813000,-39601000,2535000,735000,0,0,-4149000,-879000,4018000,133188000,283515000,150327000,169650000,38788000,130862000,,
0,2010-06-30,CECO,,,Q2,64318000,17217000,0,5039000,-31837000,0,0,0,107442000,0,-5603000,-23399000,-6194000,-65276000,0,105242000,10373000,-3980000,835000,-65276000,0,131000,-68290000,-2103000,-65623000,150326000,215949000,-5603000,23399000,-29002000,,
0,2010-03-31,CECO,,,Q1,55222000,16753000,0,4995000,0,0,0,0,139279000,0,53468000,-19757000,0,-89637000,0,79100000,-30294000,-749000,883000,-89637000,0,64000,-89439000,-2857000,-69122000,215944000,285066000,53468000,19757000,33711000,,
