,date,symbol,fillingDate,acceptedDate,period,revenue,costOfRevenue,grossProfit,grossProfitRatio,researchAndDevelopmentExpenses,generalAndAdministrativeExpenses,sellingAndMarketingExpenses,otherExpenses,operatingExpenses,costAndExpenses,interestExpense,depreciationAndAmortization,ebitda,ebitdaratio,operatingIncome,operatingIncomeRatio,totalOtherIncomeExpensesNet,incomeBeforeTax,incomeBeforeTaxRatio,incomeTaxExpense,netIncome,netIncomeRatio,eps,epsdiluted,weightedAverageShsOut,weightedAverageShsOutDil,link,finalLink
0,2019-12-28,INTC,2020-01-24,2020-01-23 18:39:55,FY,71965000000,29825000000,42140000000,0.5855624261793928,13362000000,6150000000,0.0,593000000,20105000000,49930000000,489000000,10826000000,35373000000,0.491531,22035000000,0.306191,490000000,24058000000,0.334301,3010000000,21048000000,0.292476,4.70557,4.70557,4417000000,4473000000,https://www.sec.gov/Archives/edgar/data/50863/000005086320000011/0000050863-20-000011-index.htm,https://www.sec.gov/Archives/edgar/data/50863/000005086320000011/a12282019q4-10kdocument.htm
0,2018-12-29,INTC,2019-02-01,2019-02-01 09:00:50,FY,70848000000,27111000000,43737000000,0.6173357046070461,13543000000,6750000000,0.0,128000000,20421000000,47532000000,468000000,9085000000,32870000000,0.463951,23316000000,0.329099,156000000,23317000000,0.329113,2264000000,21053000000,0.297157,4.47841,4.47841,4632000000,4728000000,https://www.sec.gov/Archives/edgar/data/50863/000005086319000007/0000050863-19-000007-index.htm,https://www.sec.gov/Archives/edgar/data/50863/000005086319000007/a12292018q4-10kdocument.htm
0,2017-12-30,INTC,2018-02-16,2018-02-16 08:31:45,FY,62761000000,23663000000,39098000000,0.6229664919297015,13035000000,7452000000,0.0,561000000,21048000000,44711000000,646000000,8129000000,29127000000,0.464094,18050000000,0.287599,-144000000,20352000000,0.324278,10751000000,9601000000,0.152977,1.98573,1.98573,4701000000,4835000000,https://www.sec.gov/Archives/edgar/data/50863/000005086318000007/0000050863-18-000007-index.htm,https://www.sec.gov/Archives/edgar/data/50863/000005086318000007/a12302017q4-10kdocument.htm
0,2016-12-31,INTC,2017-02-17,2017-02-17 08:37:46,FY,59387000000,23154000000,36233000000,0.6101166922053648,12685000000,8377000000,0.0,2180000000,23100000000,46254000000,733000000,7790000000,21459000000,0.361342,13133000000,0.221143,-192000000,12936000000,0.217825,2620000000,10316000000,0.173708,2.1161,2.1161,4730000000,4875000000,https://www.sec.gov/Archives/edgar/data/50863/000005086317000012/0000050863-17-000012-index.htm,https://www.sec.gov/Archives/edgar/data/50863/000005086317000012/a10kdocument12312016q4.htm
0,2015-12-26,INTC,2016-02-12,2016-02-12 08:09:19,FY,55355000000,20676000000,34679000000,0.6264836058169994,12128000000,7930000000,0.0,619000000,20677000000,41353000000,337000000,8711000000,23260000000,0.420197,14002000000,0.252949,506000000,14212000000,0.256743,2792000000,11420000000,0.206305,2.33347,2.33347,4742000000,4894000000,https://www.sec.gov/Archives/edgar/data/50863/000005086316000105/0000050863-16-000105-index.htm,https://www.sec.gov/Archives/edgar/data/50863/000005086316000105/a10kdocument12262015q4.htm
0,2014-12-27,INTC,2015-02-13,2015-02-13 09:11:52,FY,55870000000,20261000000,35609000000,0.6373545731161625,11537000000,8136000000,0.0,589000000,20262000000,40523000000,192000000,8549000000,24542000000,0.43927,15347000000,0.274691,94000000,15801000000,0.282817,4097000000,11704000000,0.209486,2.31487,2.31487,4901000000,5056000000,https://www.sec.gov/Archives/edgar/data/50863/000005086315000015/0000050863-15-000015-index.htm,https://www.sec.gov/Archives/edgar/data/50863/000005086315000015/a10kdocument12272014.htm
0,2013-12-28,INTC,2014-02-14,2014-02-14 09:08:47,FY,52708000000,21187000000,31521000000,0.5980306594824315,10611000000,8088000000,0.0,531000000,19230000000,40417000000,244000000,8032000000,20887000000,0.396278,12291000000,0.23319,-11000000,12611000000,0.239262,2991000000,9620000000,0.182515,1.88738,1.88738,4970000000,5097000000,https://www.sec.gov/Archives/edgar/data/50863/000005086314000020/0000050863-14-000020-index.htm,https://www.sec.gov/Archives/edgar/data/50863/000005086314000020/a10kdocument12282013.htm
0,2012-12-29,INTC,2013-02-19,2013-02-19 17:06:31,FY,53341000000,20190000000,33151000000,0.6214919105378602,10148000000,8057000000,0.0,308000000,18513000000,38703000000,90000000,7522000000,22485000000,0.421533,14638000000,0.274423,87000000,14873000000,0.278829,3868000000,11005000000,0.206314,2.13275,2.13275,4996000000,5160000000,https://www.sec.gov/Archives/edgar/data/50863/000119312513065416/0001193125-13-065416-index.htm,https://www.sec.gov/Archives/edgar/data/50863/000119312513065416/d424446d10k.htm
0,2011-12-31,INTC,2012-02-23,2012-02-23 17:05:25,FY,53999000000,20242000000,33757000000,0.6251412063186356,8350000000,7670000000,0.0,260000000,16412000000,36654000000,41000000,6064000000,23886000000,0.442342,17345000000,0.32121,135000000,17781000000,0.329284,4839000000,12942000000,0.239671,2.39179,2.39179,5256000000,5411000000,https://www.sec.gov/Archives/edgar/data/50863/000119312512075534/0001193125-12-075534-index.htm,https://www.sec.gov/Archives/edgar/data/50863/000119312512075534/d302695d10k.htm
0,2010-12-25,INTC,2011-02-18,2011-02-18 17:20:31,FY,43623000000,15132000000,28491000000,0.6531187676225844,6576000000,6309000000,0.0,18000000,13028000000,28160000000,592000000,4638000000,21275000000,0.487701,15463000000,0.354469,-10000000,16045000000,0.367811,4581000000,11464000000,0.262797,2.01264,2.01264,5555000000,5696000000,https://www.sec.gov/Archives/edgar/data/50863/000095012311015783/0000950123-11-015783-index.htm,https://www.sec.gov/Archives/edgar/data/50863/000095012311015783/f56033e10vk.htm
0,2009-12-26,INTC,2010-02-22,2010-02-22 17:14:00,FY,35127000000,15566000000,19561000000,0.5568650895322687,5653000000,7931000000,0.0,266000000,14071000000,29637000000,218000000,5052000000,10974000000,0.312409,5490000000,0.15629,-4000000.0,5704000000,0.162382,1335000000,4369000000,0.124377,0.77396,0.77396,5557000000,5645000000,https://www.sec.gov/Archives/edgar/data/50863/000095012310015237/0000950123-10-015237-index.htm,https://www.sec.gov/Archives/edgar/data/50863/000095012310015237/f54119e10vk.htm
0,2008-12-27,INTC,2009-02-23,2009-02-20 17:44:51,FY,37586000000,16742000000,20844000000,0.5545681902836163,5722000000,5452000000,0.0,710000000,13422000000,30164000000,360000000,4616000000,12662000000,0.336881,7422000000,0.197467,-96000000,7686000000,0.204491,2394000000,5292000000,0.140797,0.92067,0.92067,5663000000,5748000000,https://www.sec.gov/Archives/edgar/data/50863/000089161809000047/0000891618-09-000047-index.htm,https://www.sec.gov/Archives/edgar/data/50863/000089161809000047/f50771e10vk.htm
0,2007-12-29,INTC,2008-02-20,2008-02-19 19:50:19,FY,38334000000,18430000000,19904000000,0.519225752595607,5755000000,5401000000,0.0,532000000,11883000000,30313000000,1145000000,4798000000,15109000000,0.394141,8021000000,0.20924,0.0,9166000000,0.239109,2190000000,6976000000,0.181979,1.1752,1.1752,5816000000,5936000000,https://www.sec.gov/Archives/edgar/data/50863/000089161808000106/0000891618-08-000106-index.htm,https://www.sec.gov/Archives/edgar/data/50863/000089161808000106/f36442e10vk.htm
0,2006-12-30,INTC,2007-02-26,2007-02-23 17:40:01,FY,35382000000,17164000000,18218000000,0.514894579164547,5873000000,6138000000,0.0,597000000,12638000000,29802000000,1488000000,4912000000,13468000000,0.380646,5580000000,0.157707,0.0,7068000000,0.199763,2024000000,5044000000,0.142558,0.85782,0.85782,5797000000,5797000000,https://www.sec.gov/Archives/edgar/data/50863/000089161807000111/0000891618-07-000111-index.htm,https://www.sec.gov/Archives/edgar/data/50863/000089161807000111/f23627e10vk.htm
0,2005-12-31,INTC,2006-02-27,2006-02-24 17:40:44,FY,38826000000,15777000000,23049000000,0.5936485859990728,5145000000,5688000000,0.0,126000000,11167000000,26944000000,728000000,4595000000,17933000000,0.461881,11882000000,0.306032,0.0,12610000000,0.324782,3946000000,8664000000,0.223149,1.4024,1.4024,6106000000,6106000000,https://www.sec.gov/Archives/edgar/data/50863/000089161806000089/0000891618-06-000089-index.htm,https://www.sec.gov/Archives/edgar/data/50863/000089161806000089/f12963e10vk.htm
0,2004-12-25,INTC,2005-02-22,2005-02-18 17:51:02,FY,34209000000,14463000000,19746000000,0.5772165219679032,4778000000,4659000000,0.0,179000000,9616000000,24079000000,287000000,4889000000,15593000000,0.455816,10130000000,0.296121,0.0,10417000000,0.304511,2901000000,7516000000,0.219708,1.15738,1.15738,6400000000,6400000000,https://www.sec.gov/Archives/edgar/data/50863/000119312505033162/0001193125-05-033162-index.htm,https://www.sec.gov/Archives/edgar/data/50863/000119312505033162/d10k.htm
0,2003-12-27,INTC,2004-02-23,2004-02-20 17:50:23,FY,30141000000,13047000000,17094000000,0.5671344680003981,4360000000,4278000000,0.0,923000000,9561000000,22608000000,-91000000,5070000000,12421000000,0.412096,7533000000,0.249925,0.0,7442000000,0.246906,1801000000,5641000000,0.187154,0.85199,0.85199,6527000000,6527000000,https://www.sec.gov/Archives/edgar/data/50863/000119312504027430/0001193125-04-027430-index.htm,https://www.sec.gov/Archives/edgar/data/50863/000119312504027430/d10k.htm
0,2002-12-28,INTC,2003-03-11,2003-03-10 19:12:43,FY,26764000000,13446000000,13318000000,0.4976087281422807,4034000000,4334000000,0.0,568000000,8936000000,22382000000,-178000000,5344000000,9370000000,0.350097,4382000000,0.163727,0.0,4204000000,0.157077,1087000000,3117000000,0.116462,0.46116,0.46116,6651000000,6651000000,https://www.sec.gov/Archives/edgar/data/50863/000104746903008257/0001047469-03-008257-index.htm,https://www.sec.gov/Archives/edgar/data/50863/000104746903008257/a2104280z10-k.htm
0,2001-12-29,INTC,2002-03-13,2002-03-13 00:00:00,FY,26539000000,13487000000,13052000000,0.4918045141113079,3796000000,4464000000,0.0,16023000000,10796000000,24283000000,123000000,6558000000,8864000000,0.333999,2256000000,0.085007,0.0,2183000000,0.082256,892000000,1291000000,0.048645,0.18767,0.18767,6716000000,6716000000,https://www.sec.gov/Archives/edgar/data/50863/000091205702009698/0000912057-02-009698-index.htm,https://www.sec.gov/Archives/edgar/data/50863/000091205702009698/a2072777z10-k.htm
0,2000-12-30,INTC,2001-03-13 00:00:00,2001-03-13 00:00:00,FY,33726000000,12650000000,21076000000,0.624918,3897000000,5089000000,0.0,0.0,10681000000,23331000000,4629000000,4911000000,24681000000,0.731809,10395000000,0.308219,0.0,15141000000,0.448941,4606000000,10535000000,0.31237,1.50802,1.50802,6986000000,6986000000,https://www.sec.gov/Archives/edgar/data/50863/000091205701503434/0000912057-01-503434-index.html,https://www.sec.gov/Archives/edgar/data/50863/000091205701503434/a2040883z10-k.htm
0,1999-12-25,INTC,,,FY,29389000000,11836000000,17553000000,0.597264,3111000000,3872000000,0.0,0.0,7786000000,19622000000,1461000000,3597000000,16286000000,0.554153,9767000000,0.332335,0.0,11228000000,0.382048,3914000000,7314000000,0.248869,1.05389,1.05389,6940000000,6940000000,,
0,1998-12-26,INTC,,,FY,26273000000,12088000000,14185000000,0.539908,2509000000,3076000000,0.0,0.0,5806000000,17894000000,758000000,2863000000,12758000000,0.485594,8379000000,0.318921,0.0,9137000000,0.347771,3069000000,6068000000,0.23096,0.86254,0.86254,7035000000,7035000000,,
0,1997-12-27,INTC,,,FY,25070000000,9945000000,15125000000,0.603311,2347000000,2891000000,0.0,0.0,5238000000,15183000000,772000000,2192000000,13623000000,0.543398,9887000000,0.394376,0.0,10659000000,0.42517,3714000000,6945000000,0.277024,0.96727,0.96727,7180000000,7180000000,,
0,1996-12-28,INTC,1997-03-28 00:00:00,1997-03-28 00:00:00,FY,20847000000,9164000000,11683000000,0.560416,1808000000,2322000000,0.0,0.0,4130000000,13294000000,381000000,1888000000,10203000000,0.489423,7553000000,0.362306,0.0,7934000000,0.380582,2777000000,5157000000,0.247374,0.72593,0.72593,7104000000,7104000000,https://www.sec.gov/Archives/edgar/data/50863/000005086397000020/0000050863-97-000020-index.html,https://www.sec.gov/Archives/edgar/data/50863/0000050863-97-000020.txt
0,1995-12-30,INTC,1996-03-29 00:00:00,1996-03-29 00:00:00,FY,16202000000,7811000000,8391000000,0.517899,1296000000,1843000000,0.0,0.0,3139000000,10950000000,386000000,1379000000,7403000000,0.456919,5252000000,0.324158,0.0,5638000000,0.347982,2072000000,3566000000,0.220096,0.50424,0.50424,7072000000,7072000000,https://www.sec.gov/Archives/edgar/data/50863/000005086396000002/0000050863-96-000002-index.html,https://www.sec.gov/Archives/edgar/data/50863/0000050863-96-000002.txt
0,1994-12-31,INTC,1995-03-28 00:00:00,1995-03-28 00:00:00,FY,11521000000,5576000000,5945000000,0.516014,1111000000,1447000000,0.0,0.0,2558000000,8134000000,216000000,1047000000,4866000000,0.422359,3387000000,0.293985,0.0,3603000000,0.312733,1315000000,2288000000,0.198594,0.32723,0.32723,6992000000,6992000000,https://www.sec.gov/Archives/edgar/data/50863/000005086395000004/0000050863-95-000004-index.html,https://www.sec.gov/Archives/edgar/data/50863/0000050863-95-000004.txt
